1111111111111111111111111111111111
1E00V0000010000C00000C000000000001
101001010010000010100100000V010101
1010010010101010001001100000010011
1P0000000C00C0000000V00000000000C1
1111111111111111111111111111111111
